#.#..S....
.........#
M....@....
..........
#.........
...S...#.#