##########
#..S.S...#
#..S.S...#
#...M....#
#........#
#........#
#G.......#
###......#
#@.......#
##########