...###
..##M#.####
.##..###.S#
##........#
#...@..#..#
###..###..#
..#..#..M.#
.##.##.#G##
.#.S....##
.#.....##
.#######