#########
#.......#
#.#####.#
#.#...#.#
#.#.#.#.#
#.#.#.#.#
#.#M#.#.#
#.#S#.#.#
#@#G#...#
#########
