####..####
#..SSSS..#
#...MM...#
#........#
..........
..........
#........#
#........#
#@.......#
####..####