#.#.......
.........#
.....@....
..........
#.........
.......#.#