##########
#........#
#.M...M..#
#.S.G.S..#
#...S....#
#........#
#........#
###......#
#@#......#
##########