#########
#.......#
#.#####.#
#.#...#.#
#.#.#.#.#
#.#.#.#.#
#.#.#.#.#
#.#.#.#.#
#@#.#...#
#########
